###########
##.....###
#.....##..#
##........#
#.....#..#
###..###..#
..#..#....#
.##....#.##
.#...@..##
.#.....##
.#######